2 0 2 0 2 0 2 0
2 0 2 0 2 0 2 0
0 0 0 0 0 0 0 0
1 4 1 4 1 4 1 4
1 4 1 4 1 4 1 4
5 0 0 0 0 0 0 5
3 0 3 0 0 0 0 0
0 3 0 3 0 0 0 0
0 0 3 0 3 0 0 0
0 0 0 3 0 3 0 0
0 0 0 0 3 0 3 0
0 0 0 2 0 3 0 3
0 0 2 0 0 0 3 0
0 2 0 0 0 0 0 0
2 0 0 0 0 0 0 0
0 0 0 0 0 0 0 0
0 1 0 1 0 1 0 0
1 0 1 0 1 0 0 0
0 1 0 1 0 1 0 0
0 0 1 0 1 0 1 0
0 0 0 1 0 1 0 1
0 0 0 0 0 0 0 0
2 2 2 0 0 0 0 0
0 2 2 2 0 0 4 0
0 0 2 2 2 0 4 0
0 0 0 2 2 2 4 0
0 0 2 2 2 0 4 0
0 2 2 2 0 0 4 0
2 2 0 0 0 0 4 0
0 0 0 0 0 0 0 0
1 3 1 3 1 3 1 3