4 4 0 0 0 0 0 0
0 4 4 0 0 0 0 0
0 0 4 4 0 0 0 0
0 0 0 4 4 0 0 0
2 2 0 0 4 4 0 0
2 2 2 0 0 4 4 0
2 2 2 2 0 0 4 4
0 0 0 0 0 0 0 4
3 0 3 0 3 0 3 0
0 1 0 1 0 1 0 1
0 1 0 1 0 1 0 1
0 0 4 3 4 0 0 0
0 0 3 5 3 0 0 0
0 0 4 3 4 0 0 0
2 1 2 1 2 1 1 2
0 0 0 0 0 0 0 0
0 0 0 0 0 4 4 4
0 0 0 4 4 4 0 0
0 4 4 4 0 0 0 0
4 4 0 0 0 0 0 0
0 0 0 1 1 1 1 1
0 0 0 0 1 1 1 1
0 0 0 0 0 1 1 1
0 0 0 0 0 0 1 1
0 0 0 0 0 0 2 2
0 0 0 0 0 2 0 0
0 0 0 2 2 0 0 0
0 0 2 2 0 0 0 0
0 0 2 0 0 0 0 0
0 2 0 0 0 4 0 4
2 0 0 0 0 0 4 0
0 2 0 0 0 4 0 4
0 0 2 0 0 0 0 0
0 0 2 2 0 0 3 0
0 0 0 2 2 0 0 0
3 0 0 0 0 2 2 0